# HXTP Embedded SDK â€” Arduino Keywords
# Syntax Highlighting for Arduino IDE

# Classes (KEYWORD1)
HXTPClient	KEYWORD1
HxtpCore	KEYWORD1
CapabilityRegistry	KEYWORD1
ValidationContext	KEYWORD1
NonceCache	KEYWORD1
SequenceTracker	KEYWORD1
HXTPConfig	KEYWORD1
HxtpCapabilityResult	KEYWORD1
HxtpValidationResult	KEYWORD1
HxtpInboundFrame	KEYWORD1
HxtpMessageHeader	KEYWORD1
HxtpCommandPayload	KEYWORD1
HxtpOutboundContext	KEYWORD1

# Methods (KEYWORD2)
begin	KEYWORD2
connect	KEYWORD2
disconnect	KEYWORD2
loop	KEYWORD2
registerCapability	KEYWORD2
publishState	KEYWORD2
publishTelemetry	KEYWORD2
isConnected	KEYWORD2
isWiFiConnected	KEYWORD2
isMqttConnected	KEYWORD2
stateStr	KEYWORD2
deviceId	KEYWORD2
tenantId	KEYWORD2
onStateChange	KEYWORD2
onError	KEYWORD2

# Constants (LITERAL1)
HXTP_VERSION_STRING	LITERAL1
HXTP_FRAMER_VERSION	LITERAL1
HXTP_PROTOCOL_MAJOR	LITERAL1
HXTP_PROTOCOL_MINOR	LITERAL1
HXTP_MAX_PAYLOAD_BYTES	LITERAL1
HXTP_HEARTBEAT_INTERVAL_S	LITERAL1
HXTP_SECRET_LEN	LITERAL1
HXTP_SHA256_HEX_LEN	LITERAL1
HXTP_HMAC_HEX_LEN	LITERAL1
HXTP_NONCE_CACHE_SIZE	LITERAL1
HXTP_MAX_CAPABILITIES	LITERAL1

# Enums (LITERAL1)
HxtpError	LITERAL1
HxtpClientState	LITERAL1
HxtpMessageTypeBin	LITERAL1
HxtpValidationStep	LITERAL1
